close=Close
next=Next
previous=Back
controls=Controls
resume=Resume
restart=Restart
main_menu=Main Menu
settings=Settings
chapter=Chapter
timebazaar=Time Bazaar
sound=Sound
credits=Credits
language=Language
back=Back
forward=Forward
writing_on_wall_one=We were dancing
writing_on_wall_two=on the edge of ruin
writing_on_wall_three=chased by the darkness in our hearts
dailydealin=New Daily Offer In: 
buyalevel=Pre-Order \nNext Level
buyalllevels=Buy Season Pass
tut_1move=Tap to guide\nThe Ballerina
tut_2TapAndHold=Objects that are frozen\nin time react when\nThe Ballerina is close to them.\nTap and hold to interact
tut_3SliderForward=Tap and hold to unfold time
tut_4SliderBackward=Tap and hold to reverse time
tut_5move=Tap the ground to move across
tut_6PickupItem=Help The Ballerina restore time\nby collecting the timepieces\nof the broken clock
tut_7TapAndHoldPlatform=Activate the object\nand move it into a position\nwhere The Ballerina\ncan jump onto the object\nby tapping on it
tut_2_1ShowLightning=Now that a part of the clock has been restored, The Ballerina can use its time energy to power up machines
tut_2_2ShowTesla=Conductors can be used to receive and redirect time energy, time energy will always go to the nearest conductor or receiver, as long as it's not broken or encapsulated by glass
tut_2_3ShowConductor=Small receivers need time energy to activate the machines on which they are positioned
sfx=Sound Effects
master=Master
music=Music
purchased=Purchased
thanksforpurchase=Thanks for your purchase \n (no real money has been spent)
not_enough_money=Not enough funds to buy season pass \n (it's fake anyway)
fakeshop=Mockup shop
abouttoreset=Do you want to reset \nall level progress?
cancel=No
confirm=Yes
start=Start
purgesaves=Clear Progress