close=Luk
next=Næste
previous=Tilbage
controls=Kontroller
resume=Fortsæt
restart=Genstart
main_menu=Hovedmenu
settings=Indstillinger
chapter=Afsnit
timebazaar=Tidsbazar
sound=Lyd
credits=Holdet Bag
language=Sprog
back=Tilbage
forward=Frem
writing_on_wall_one=Vi dansede
writing_on_wall_two=på ruinens kant
writing_on_wall_three=forfulgt af mørket i vores hjerter
dailydealin=Nye dagstilbud om: 
buyalevel=Forudbestil\nnæste bane
buyalllevels=Køb Sæsonpas
tut_1move=Tap for at\nguide Ballerinaen
tut_2TapAndHold=Objekter, der er frosset\ni tiden, reagerer når\nBallerinaen er tæt på dem.\nTap og hold for at interagere
tut_3SliderForward=Hold knappen nede for at\nbevæge objekter fremad i tiden
tut_4SliderBackward=Hold knappen nede for at\nbevæge objekter tilbage i tiden
tut_5move=Tap på jorden for at gå rundt
tut_6PickupItem=Hjælp Ballerinaen med at\ngenoprette tiden, ved at samle\ntidsstykker fra det ødelagte ur
tut_7TapAndHoldPlatform=Aktivér objektet og \n bevæg det til en position, \nhvor du kan hoppe op\npå det med et tap
tut_2_1ShowLightning=Nu hvor en del af uret er blevet repareret, kan Ballerinaen bruge dets tidsenergi til at aktivere maskiner
tut_2_2ShowTesla=Ledere kan bruges til at modtage og sende tidsenergi. Tidsenergi vil altid binde sig til den nærmeste modtager eller leder, så længe de ikke er gået i stykker eller er indkapslet i glas
tut_2_3ShowConductor=Led tidsenergien til modtagerne på visse maskiner, for at aktivere deres funktion.
sfx=Lydeffekter
master=Master
music=Musik
purchased=Købt
thanksforpurchase=Tak for handlen\n(Ingen rigtige penge blev brugt)
not_enough_money=Ikke nok penge til at købe sæsonpas \n (Det er falskt alligevel)
fakeshop=Demo butik
abouttoreset=Vil du fjerne alt\nfremskridt i banerne?
cancel=Nej
confirm=Ja
start=Start
purgesaves=Nulstil Baner
